
F 210,105,30

C 0,0,255
NO ./textures/NO.xpm
SO ./textures/SO.xpm
WE ./textures/WE.xpm
EA ./textures/EA.xpm

11111111111111111111111111111111111111111
10000000000000000000000000000000000000001
10111111111111111111111111111111111111101
10000000000000000000000000000000000000001
10111111111111111111111111111111111111101
10000000000001000000000100000000000000001
10111111111111111111111111111111111111101
10100000000000000000000000000000000000101
10111111111111000000000111111111111111101
100000000000000000N0000000000000000000001
10111111111111000000000111111111111111101
10100000000000000000000000000000000000101
10111111111111111111111111111111111111101
10000000000001000000000100000000000000001
10111111111111111111111111111111111111101
10000000000000000000000000000000000000001
10111111111111111111111111111111111111101
10000000000000000000000000000000000000001
11111111111111111111111111111111111111111







